0000000000000000000000000000000000000000000000000100
1010010011101110111011000001100110011101110111000010
1010101010001000100010100001010101001001010100001001
1010101011101110111011001101110101001001110111000001
0100111000100010100010100001010101001000010101001001
0100101011101110111010100001100110011001110111000010
0000000000000000000000000000000000000000000000000100