0000000000000000000000000000000000000000000000010000
0101001001110111011101100110011001110111011100001000
0101010101000100010001010101010100100101010000100100
0010011101110111011101100110010100100111011100000100
0010010100010001010001010101010100100001010100100100
0010010101110111011101010111011001100111011100001000
0000000000000000000000000000000000000000000000010000
