0000000000000000000000000000000000000000000000000000
1111011101111101001011110111000000000000000000000000
1001001000010001001010010100100000000000000000000000
1000001000010001111010010111000000000000000000000000
1011101000010001001010010100100000000000000000000000
1001001000010001001010010100100000000000000000000000
1111011100010001001011110111000000000000000000000000