0000000000000000000000000000000000000000000000001000
0010100100111011101110110011001100111011101110000100
0010101010100010001000101010101010010010101000010010
0001001110111011101110110011001010010011101110000010
0001001010001000101000101010101010010000101010010010
0001001010111011101110101011101100110011101110000100
0000000000000000000000000000000000000000000000001000