0000000000000000000000000000000000000000000000100000
1010010011101110111011001100110011101110111000010000
1010101010001000100010101010101001001010100001001000
0100111011101110111011001100101001001110111000001000
0100101000100010100010101010101001000010101001001000
0100101011101110111010101110110011001110111000010000
0000000000000000000000000000000000000000000000100000