1000001100000110000011000001100000110000011000001100
1100000110000011000001100000110000011000001100000110
0110000011000001100000110000011000001100000110000011
0011000001100000110000011000001100000110000011000001
0001100000110000011000001100000110000011000001100000
0000110000011000001100000110000011000001100000110000
0000011000001100000110000011000001100000110000011000
